{
    "id": 0,
    "title": "Dialog system",
    "levelLayout": [
        "SP .  .  .  .  .  .  .  .  .  .  .  .  .  .  .  .  .  .  . ",
        ".  .  .  .  W0 W0 W0 W0 .  .  W0 W0 W0 W0 W0 .  .  .  .  . ",
        ".  .  .  .  W0 .  .  W0 .  .  .  .  W0 .  .  .  .  .  .  . ",
        ".  .  .  .  W0 .  .  W0 .  .  .  .  W0 .  .  .  F0 .  .  . ",
        ".  .  .  .  W0 .  .  W0 .  .  .  .  W0 .  .  .  .  .  .  . ",
        ".  .  .  .  W0 .  W0 .  .  .  .  .  W0 .  .  .  .  .  .  . ",
        ".  .  .  .  W0 W0 .  .  .  SP .  .  W0 .  .  .  .  .  .  . ",
        ".  .  .  .  W0 .  W0 .  .  .  .  .  W0 .  .  .  .  .  .  . ",
        ".  .  .  .  W0 .  .  W0 .  .  .  .  W0 .  .  .  .  .  .  F0",
        ".  .  .  .  W0 .  .  W0 .  .  .  .  W0 .  .  .  .  F0 .  . ",
        ".  .  SP .  W0 .  .  W0 .  .  .  .  W0 .  .  .  .  .  .  . ",
        ".  .  .  .  W0 .  .  W0 .  .  W0 W0 W0 W0 W0 .  .  .  .  F0",
        ".  .  .  .  .  .  .  .  .  .  .  .  .  .  .  .  .  .  .  . ",
        "SP .  .  .  .  .  .  .  .  .  .  .  .  .  .  .  .  .  .  . "
    ],
    "constraints": {
        "maxTimeSec": 30
    }
}
