{
    "id": 0,
    "title": "Dialog system",
    "levelLayout": [
        "SP .  .  .  .  .  .  .  .  .  .  .  .  .  .  . ",
        "SP .  W0 W0 W0 W0 .  .  W0 W0 W0 W0 W0 .  .  . ",
        ".  .  W0 .  .  W0 .  .  .  .  W0 .  .  .  .  . ",
        ".  .  W0 .  .  W0 .  .  .  .  W0 .  .  F0 .  . ",
        ".  .  W0 .  .  W0 .  .  .  .  W0 .  .  .  .  . ",
        ".  .  W0 .  W0 .  .  .  .  .  W0 .  .  .  .  . ",
        ".  .  W0 W0 .  .  .  SP .  .  W0 .  .  .  .  . ",
        ".  .  W0 .  W0 .  .  .  .  .  W0 .  .  .  .  . ",
        ".  .  W0 .  .  W0 .  .  .  .  W0 .  .  .  .  F0",
        "SP .  W0 .  .  W0 .  .  .  .  W0 .  .  .  .  . ",
        ".  .  W0 .  .  W0 .  .  W0 W0 W0 W0 W0 .  .  F0",
        ".  .  .  .  .  .  .  .  .  .  .  .  .  .  F0 F0"
    ],
    "constraints": {
        "maxTimeSec": 15
    }
}
